00000000000000000000000000000000000000000000000000000000000000000000000000000000000000000000000000000
00000000000000000000000000000000000000000000000000000000000000000000000000000000000000000000000000000
00000000000000000000000000000000000000000000000000000000000000000000000000000000000000000000000000000
00000000000000000000000000000000000000000000000000000000000000000000000000011100000010000001100000300
00000000000000000000000000000000000000000000000000000000000000000000001010011100000000000000000012421
00000000000000000000000000000000000000000000000000000000111000000110000000011100000000000000000000000
00000000100000000000000000000000000000000000000110000001110000000110000000011100000000000000000000000
11700000000000070000000000000000000000000000000011000000000000000000000000011100000000000000000000000
11000000000000000000000000000000000000000000000000000111000000000000000000011100000000000000000000000
11777777777777777110000001110000000000000000111000000111000000000000000000011100000000000000000000000
11111111111111111110000001110000000000111000111000000000000000000000000000011100000000000000000000000
11111111111111111110000001110000000000111000111000000000000000000000000000011100000000000000000000000
11111111111111111110000001110000011000111000111000000000000000000000000000011100000000000000000000000
11111111111111111110000001110000011000111000111000000000000000000000000000011100000000000000000000000
11111111111111111110000001110000011000111000111000000000000000000000000000011100000000000000000000000
11111111111111111110000001110000011000111000111000000000000000000000000000011100000000000000000000000
11111111111111111110000001110000011000111000111000000000000000000000000000011100000000000000000000000
