00000000000000000000000000000000000000000000000000000000000000000000000000000000000000000000000000000
00000000000000000000000000000000000000000000000000000000000000000000000000000000000000000000000000000
00000000000000000000000000000000000000000000000000000000000000000000010000000000000000000000100000000
00000000000000000000000000000000000000000000000000000000000000000000000001210000000000000001100000300
00000000000000000000000000000000000000000000000000000000000000000000000000000000000000000000000012421
000000000000000000000000000000012100000000000000000000000000011001100000000000000000001200000000000000
000000001111000000000000000000000000000000000000000000000001101100000000000000000000000002100000000000
0000000000000000000000110000000000001111000000000000000000011000000000000000001110000000000000000000000000
110000000000000001100000001100000000000111100000000001111000000000000000000000000000000000000000000000
11111111111111111110000000000000000000000000000000000000000000000000000000000000000000000000000000000
111111111111111111100000000000000111100000000000000000000000000000000000000000000000000000000000000000000
11111111111111122110000000000000000000000000000000000000000000000000000000000000000000000000000000000
11111111111111111111000000000011441100000000000001441000000000000000000000000000000000000000000000000
11111111111111111110000000000000000000000000000000000000000000000000000000000000000000000000000000000
11221111111111122110000000000000000000000000000000000000000000000000000000000000000000000000000000000
11111111111111111110000000000000000000000000000000000000000000000000000000000000000000000000000000000
11112211111112211110000000000000000000000000000000000000000000000000000000000000000000000000000000000