00000000000000000000000000000000000000000000000000000000000000000000000000000000000000000000000000000
00000000000000000000000000000000000000000000000000000000000000000000000000000000000000000000000000000
00000000000000000000000000000000000000000000000000000000000100022000000000000000000000000000000000000
00000000000000000000000000000000000000000000000000000111000000022000010001010000011000001100000030000
00000000000000000000000000000000000000000011111000000111000000022000000000000000000011000000000111100
00000000000000000000000000000000111111000011111000000111000000022000000000000011000000000000000000000
00000000110000000000000000000000222222000011111000000111000000022000000000000000000000000000000000000
00000000000000000000000000000000222222000000000000000111000000022000000000000000000000000000000000000
11000000000000000000000000111100111111000000000000000111000000022000000000000000000000000000000000000
11777000000077770000000100111100000000000000000000000110000000022000000000000000000000000000000000000
11111111111111111110000000111100000000000000000000000111000000022000000000000000000000000000000000000
11111111111111111110000000111100000000000000000000000111000000022000000000000000000000000000000000000
11111111111111111110000000111100000000000000000000000111000000022000000000000000000000000000000000000
11111111111111111110000000111100000000000000000000000111000000022000000000000000000000000000000000000
11111111111111111110000000111100000000000000000000000111000000022000000000000000000000000000000000000
11111111111111111110000000111100000000000000000000000111000000022000000000000000000000000000000000000
111111111111111111100000001111000000000000000000000001110000000220000000000000000000000000000000000000
