00000000000000000000000000000000000000000000000000000000000000000000000000000000000000000000000000000
00000000000000000000000000000000000000000000000000000000000000000000000000000000000000000000000000000
00000000000000000000000000000000000000000000000000000000000000000000000000111000100100010001100000300
00000000000000000000000000000000000000000000000000000000000000000000000000111000000000000000000012421
00000000000000000000000000000000000000000000000000000000000000000011111000111000000000000000000000000
00000000110000000000000000000000000000000000000000000000000000000011111000000000000000000000000000000
10000000000000000000000000000000000000000000000001110000111111100011111000000000000000000000000000000
11000000000000000000000000000000000000000011100001110000111111100011111000000000000000000000000000000
11000000000000000000000000000000001110000011100000000000000000000011111000000000000000000000000000000
11111111111111111111110011111100001110000000000000000000000000000011111000000000000000000000000000000
11221112111211122111110011111100000000000000000000000000000000000011111000000000000000000000000000000
11111111111111111111110011111100000000000000000000000000000000000011111000000000000000000000000000000
11111111111111111111110011111100000000000000000000000000000000000011111000000000000000000000000000000
11221111111111122111110011111100000000000000000000000000000000000011111000000000000000000000000000000
11111111111111111111110011111100000000000000000000000000000000000011111000000000000000000000000000000
11112211111112211111110011111100000000000000000000000000000000000011111000000000000000000000000000000
