000000000000000000000000000000020000000000000000
000000000000000000000000000000002000000000000000
000000000000000000000000000000000000000000000400
000000000000000000000000000000002220022200066666
000000000000000000000000000000000000000000000000
000000000000000000000000000002000000000000000000
000000000000000000000000000000002000000000000000
000000000000000000000000000000000000000000000000
220000000000000002200000022000222000000000000000
112222222222222221100002211200111000000000000000
111111111111111111100001111100010000000000000000
111111111111111111100000110000000000000000000000
111111111111111111100000100000000000000000000000
111111111111111111100000100000000000000000000000
111111111111111111100000000000000000000000000000