0000000000000000000000000000000000000000000000000000000000000000000000000000000000000000000000000000000
0000000000000000000000000000000000000000000000000000000000000000000000000000000000000000000000000000000
0000000000000000000000000000000000000000000000000000000000000000000000000000000000000000000000000000000
0000000000000000000000000000000000000000000000000000000000000000000000000000000000000000000000000000000
0000000000000000000000000000000000000000000000000000000000000000000000000000000000000000000000000000000
0000000000000000000000000000000000000000000000000000000000000000000000000000000000000000000000000000040
0000000000000000000000000000000000000000000000000000000000000000000000000000000000000000000000000000666
0000000000000000000000220000000000002200000022000000020000000000000002200000000000000000000000000000000
2200000000000000022000000000000000000000000000011000000000000000000000000000000000000000000000000000000
1122222222222222211000000222222222222200002222222222222200000222222222222220000002222222222200022002200
1111111111111000000000000111111111111100001111111111111100000000000000000220000000000000000000000000000
1111116661111000000000000000000000000000000000000000000000000000000000000000000000022000000000000000000
1111111161111000000000000000000000000000000000000000000000000000000000000000000000000000000000000000000
1111116661111000000000000000000000000000000000000000000000000000022222220000000000000000000000000000000
1111111161111000000000000000000000000000000000000000000000000000000000000000000000000000000000000000000
1111116661111000000000000000000000000000000000000000000000000000000000000000000000000000000000000000000