00000000000000000000000000000000000000000000000000000000000000000000000000000000000000000000000000000
00000000000000000000000000000000000000000000000000000000000000000000000000000000000000000000000000000
00000000000000000000000000000000000000000000000000000000000000000000000000000000000000000000000000000
00000000000000000000000000000000000000000000000000000000000000000000000000000000000007770000000030000
00000000000000000000000000000000000000000000000000000000000000000000000000000000000001110000001771000
00000000000000000000000000000001001000000000000000000000000007770000000000000000077700000000000000000
00000000100100000000000000000000000000000000000007777000000001110000000007770000011100000000000000000
00000000000000000000000000000000000000000000000001111000000000000000000001110000000000000000000000000
110000000000000001100000000000000000000077777000000000770000000000000000000000000000000000000000000000
117777777777777771177777777007777777000011111000000000110000000007777000000000000000000000000000000000
111111111111111111111111111001111111000000000000000000000000000001111000000000000000000000000000000000
111111111111111111100000000000000000000000000000000000000000000000000000000000000000000000000000000000
11111111111111111110000000000000000000000000000000000000000000000000000000000000000000000000000000000
11111111111111111110000000000000000000000000000000000000000000000000000000000000000000000000000000000
11111111111111101110000000000000000000000000000000000000000000000000000000000000000000000000000000000
11111111111111111110000000000000000000000000000000000000000000000000000000000000000000000000000000000
11111111111111111000000000000000000000000000000000000000000000000000000000000000000000000000000000000
