00000000000000000000000000000000000000000000000000000000000000000000000000000000000000000000000000000
00000000000000000000000000000000000000000000000000000000000000000000000000000000000000000000000000000
00000000000000000000000000000000000000000000000000000000000000000000010000000000000000000000000000000
00000000000000000000000000000000000000000000000000000000000000000000000001210000000000000001100000300
00000000000000000000000000000000000000000000000000000000000000000000000000000000000000000000000012421
00000000000000000000000000000001110000000000000000000000000001441000000000000000000012000000000000000
00000000100100000000000000000000000000000000000000000000000000000000000000000000000021000000000000000
00000000000000000000000000000000000000000000000000000000111100000000000000000000000000000000000000000
11000000000000000000000000000000000000000000000000101000111100000000000000000000000000000000000000000
11110000000000000000000000000000000000000011111000000000000000000000000000000000000000000000000000000
11111111111111111110000001111111000000000011111000000000000000000000000000000000000000000000000000000
11111111111111111110000001111111000000000000000000000000000000000000000000000000000000000000000000000
11111111111111111110000001111111000011000000000000000001441000000000000000000000000000000000000000000
11111111111111111110000001111111000011000000000000000000000000000000000000000000000000000000000000000
11111111111111111110000001111111000011000000000000000000000000000000000000000000000000000000000000000
11111111111111111110000000000000000011000000000000000000000000000000000000000000000000000000000000000
11111111111111111110000000000000000011000000000000000000000000000000000000000000000000000000000000000
