00000000000000000000000000000000000000000000000000000000000000000000000000000000000000000000000000000
00000000000000000000000000000000000000000000000000000000000000000000000000000000000000000000000000000
00000000000000000000000000000000000000000000000000000000000000000001110000000000000000000000000000000
00000000000000000000000000000000000000000000000000000000000000000000000111000000000000000001100000300
00000000000000000000000000000000000000000000000000000000000000000000000111000001000001100000000012421
00000000000000000000000000000000000000000000000000000000000001100000000000000000011000000000000000000
10000000000000000000000000000000000000000000000000000000000001100000000000000000011000000000000000000
10000000000000000000000000000000000000000000000000000000000000000000000000000000000000000000000000000
11000000000000000000000000000000000000000000000000011111000000000000000000000000000000000000000000000
11000000000000000000000000000000111000000000000000011111000000000000000000000000000000000000000000000
11111111111111111110000111110000000000000111100000000000000000000000000000000000000000000000000000000
11111111111111111110000111110000000000000000000000000000000000000000000000000000000000000000000000000
11111111111111111110000111110000001111110000000000000011111000000000000000000000000000000000000000000
11111111111111111110000111110000001111110000000000000000000000000000000000000000000000000000000000000
11111111111111111110000111110000001111110000000000000000000000000000000000000000000000000000000000000
11111111111111111110000111110000001111110000000000000000000000000000000000000000000000000000000000000
11111111111111111110000111110000001111110000000000000000000000000000000000000000000000000000000000000
